BBBBBBBBBBBBBBBBB
B  EE   EEE E  EB
B B BEBEB BEB B B
BE E E   EE  EE B
BEBEBEB B B BEB B
B E  EE  E   E  B
B B B B BEBEBEBEB
B EEE E  EEE   EB
BEB B B B B B BEB
BE  EEE  E EE  EB
BEB B B BEB B BEB
B EEEEEEE  E   EB
B B B B B BEB BEB
BEEE E E E E  E B
B BEB BEB B B B B
B  E E E E EEE  B
BBBBBBBBBBBBBBBBB