BBBBBBBBBBBBBBBBB
B   EE  EEE   EEB
B BEBEB BEB BEBEB
BEE EE  EEEEEEEEB
BEB BEBEBEBEB BEB
BE  EE  EEE E   B
BEBEBEB BEB BEBEB
BE  EE   EE   EEB
BEB B BEBEBEBEB B
BEEE   EE EEEE  B
BEBEBEBEB BEBEBEB
BE   EEE   EE   B
BEB BEBEBEB BEB B
BEEEE   EEE   EEB
B BEBEB B BEBEB B
B   EEEEE  EEE  B
BBBBBBBBBBBBBBBBB
