BBBBBBBBBBBBBBBBB
B   EE   EEEE   B
BEB BEB BEB BEB B
BEEEEE  EE  EEE B
BEB BEBEBEBEBEBEB
BE  EEE   EEEE  B
BEB BEBEB BEBEB B
BEEEE  EE E   EEB
BEBEB BEBEB BEBEB
B   EEE   EEE   B
BEB B B BEBEB B B
B  E  EEE   EEEEB
B BEBEBEB BEBEBEB
B EE   EEE  EEE B
BEB B B BEB BEB B
B   EEE   EEE   B
BBBBBBBBBBBBBBBBB
