BBBBBBBBBBBBBBBBB
B    EE   EE    B
B BEBEB BEBEB BEB
BEE   EEEEEEEE  B
BEB BEBEB BEBEB B
BEE EEE   EEE EEB
B BEBEBEBEBEB BEB
B  EEEE   EEE  EB
BEBEB BEB BEBEBEB
B  EE   EEEE  EEB
B BEBEBEBEBEB BEB
B EE  EE  EEE EEB
BEBEB BEB B BEBEB
B EEE EEEE  EEE B
B BEBEBEB BEBEB B
B  EEEEE   EEE  B
BBBBBBBBBBBBBBBBB
