BBBBBBBBBBBBBBBBB
B  EEE   EE   EEB
B BEB B BEBEB BEB
BEEE   EE   EEEEB
BEBEBEBEB BEB BEB
B    EE EEEE    B
BEB BEB B BEBEBEB
B EEEE  E  E  EEB
B BEBEBEBEBEB BEB
B  EEEE   EEE EEB
BEBEB BEB BEBEBEB
B  EE  EE EEEE  B
B BEB BEBEB BEB B
BEEEEEE EE  EEE B
BEB BEB BEBEB BEB
B   EEE   EEE   B
BBBBBBBBBBBBBBBBB
